.***#***
***.#***
*.**#***
**.*#***
########
*..*#***
.*.*#*.*
**.*#*.*
.*.*#**.
**.*#***
