**.*.******.******.**.*.*******.****.***.*****..**#.****...*****....******..*******.**.***.***.*****
*.*.*.*..****.**.***********.****.*****....***..**#.***.*.***.**.*******..********.*.*...*.*...*****
********..***.******.***.****.*.**.********..*.**.#***.*..*.*.**...**.**..***.*.*****....*.***.****.
....****........*.*..*****.***..******.******.*..*#*.**..***.*.*....**.*****.*.*..*****...*..****..*
****.******.*.********.**.***..***.*.*****..***.**#**.***.*.*********...****..****..*..*****..***..*
****.*****.*..**.******.*.***.*.***.***..*.****.**#**.**.****.*******.****..*.*.****...*.*.*..***...
**.***.*......***.*.***.*****.**.*******.****.****#*.*.*.**.*..**.*.*..****.***********.******.*****
***.***.*.****...*..**********..*.*****.*.********#..***.*...*.*.******.*.....*.****.**.****.****.*.
******.**...*..***.**.******.***..*..**.*********.#*.*.*..**...*****.*.**.*...**.*.**.*.**.******.**
.*...*.*.**...******.*..*.**.***.****.*********.**#.**.**.******...**...***..*.**...****.*******.**.
*.*.***************.*..***..****.********.*.*.***.#**...**.*.*****...***..*.****.*.*.***********.*.*
*.*.****..*.*******.*******.***.*.*.**..*.*****..*#..*.***.***.*****..**.******.*.******.********.**
**.*****..****...**.*.***.*..*.***..***.****.*****#*...****.***********.**.*....***************..*.*
**************..*...*.******.***.**.**....*.****.*#***.*..*.*.**..***.**..*.*..*..*.***********.*.**
******....*********.*.***.....**.****.**.*.**..***#.*.*...**********.*...**...*.**.*.***.********.*.
**..*...******.*****.*.**.***.**.****.*****..*.***#***.******.*..*..**.***.****..************.***..*
***.*..**.****..***.*..**..*********.****..*******#****.******.**.*...**.********.*.*...****.*.*.**.
*..*.....*****..*.***.***.*.***...****..*..*..*.**#.**..***.***..********.*.**.*.*****.*.***.*.**.**
*.*.*.**..***.*****.**********..******..*****.*.*.#*******..*****..*..*.***.****.*********.*...*...*
*****.***.**.*.***.**..*.*****..*.***..***....**.*#*.*....***.***.*.************....***.****.*.**..*
**.**....************.*.**....*****...**....**.***#****.*******.*...*.*.*.*****.**.***..*.*******..*
*..*..*******.*..**.***..***.******.**.*.**.******#*******.***.******.**....**...****.***.*...***.**
*.****..*..**.********.*.**.*.****.****.**.*..**..#******.*.****.***..****.*.**.*****.*.*..**..****.
**...*...*..*.******.**.**.*****.*...**..***..**.*#.***.*..*..******.*********.******.*.**.....****.
.*.**.*.**.***.*...*..***....*..**..*******.****.*#***.***.***.**..*.**.***..**.*.*...****.*.*******
*.**.*****.***..*.**.******..*****.....*.*****.**.#*************.*...****.*****.*.*********.****.*..
*.*.**.*.**..**..****.********..*..**..******.*...#.**********.*.*.****..***.*..*..*....*.**.**.****
**...*****.*.********.*.*.*.***.**...******.*****.#.**...*********.*..**.*.*.***.****..*.**********.
.*.**.*******.***.***.*..*...*.*...*...*.*.*.*.***#*.*...*.*.*****.*.**.*****..**...*...*****.******
..***.****...*****..*.*.*...**..***.*.**.***.**.**#*******.**.*..*.*.**...****.*.**...****.*.******.
**.**..**...***..*******.*...***..*....*..**..****#*.*******....**.****..***.****.*****...***.***..*
*..**.****.****.*.***.***.****..*.***.*....***..*.#.******.***..***...******..***********.*.**.*.**.
.***.***.**...*.*..*...**.*..***.***.*****.***.**.#******.***..**.*.**..*.***...*...**.*****.*.*..**
****..*********...***......*.**.*.*******.*.****.*#....***..***.***..*..****.*..***.*..*.***.**..*..
**..*******.*.*.*..**.*.*.*...***..**.**.**..***.*#*.*.******.******.*.***.******..***.*.*.**.**.*.*
*********.*.**.**...******.***.**.*.**.**.*.**.*.*#.*.*.*..*..**.**.*****.*.**.*.*..****...****.**.*
*******.*****.****..**.*.***.****.*.****.*.....***#**..*...*******.***.*****.*****.***.*****.*****.*
*.***.***********.*...***...***.*****.*.*.*****.*.#***********.*.****..*.******..***...*..**.*.***.*
*..********.******.***.****..******.***.**..*..***#**.**.********.**.***.**...**..***.**.**.*******.
.*************.***.******.*.*.*..*...******.**..**#**.*....**..*.*...*..**.*.****..**.*******..**..*
***..**..*..*.****.***.*******.**...****.***..**.*#****..**..*.*..****..******.*.*.*.**...***.**.***
**.***.***.**********.**.*.**.*****.*...*.**.*****#**.*....**.*.**..*****..*.**.******.***.******..*
**.***...*.*******.**.**.*.***..*..**.*..*.*..****#.**..**.******..*..*.**.*******..*...*********..*
****.*.**.**.******..*.***.****..********.***.**.*#**.****.**..**********.*.*.*..*.**..*.*****.**..*
*.*********..**.**.*..*.**..*.**.*.****.***..*****#****..***.**.****.***.**.*********..***..*.*****.
********.*..*****..*.*...***..*****..***...*.***.*#*..***.******.******.**.*******.*********.***.***
..***.****.**.*...**.*.*****.**************..*****#..*****..*.***.**.***.***.*.*****.*..*****..***.*
****.**.*********..*.*..***.**.**..*.**.****..**.*#*****..**.**..*.**.*.*******.**.**..*****.****.**
****.**.**...***.*.**..**.**.*.*.**..*..**..*.*..*#.*.**..*.*****.*..*.*********.**.**.*.*...*...*.*
*..*.***....*..**....*.***..***.******..****.***.*#******..*.*.**.********..*..**..**..*.*...*.***.*
####################################################################################################
***.*.*.******.***********.***.*****.**.*.*....**.#**...******..***.*.*****.******.*.*.***.*.***.**.
*.*****..**..******...*.*.**.*.*.****.*******...**#**..*.*****..*******.*..****.*.*.***.***....***.*
..**..*********.*..***..**.**.*.**.*..*..**.*.**..#..*************.*********...*..***..**.*******.*.
.*.**.**.******.*...***..***.**.*....**.******...*#.****.*.*.*.*..**.***.***.*****.******..***.***.*
*.*******.*.**..*******.**.*.*.*.*.**.*..**..**.**#.**.*..*.******.****.**.*****.*.****.********.***
*********..**********.******.*.*..*.*.********.*..#**.**.******..**.**..****.*...*.**.******..**.*..
**********...**...***.*.*.******.***....*.********#****...*..*.*.**..****.*.**.*****.****.***.*..**.
**......**.**.**..**..*..****.*...*******.*.******#.**.******.*..**..**.**.*...**.********.****..**.
**.***.******.*..**.*.*****.**.*.*.**..*******.*.*#.*...****.*****.***..**..**..**.**..**.**.***.***
*..***.********..*..**.****.*.*.**....***..*..**.*#**.*.**..**.**.*.*.****.*******..****.*****....*.
.*...*********..**.***...******.****.*..****.*.**.#*.**...*****.***...***.*.*.********..*.*.**.***.*
*.**.*****.*.*.********..****.**..***..***.***.***#****..***...*.**.*.*****.******.****.**.**.*...**
*.*.**.**....**.*.*....******..**.***.***.****.***#*.*****..*.*.*****..*.**.************..*.***.**..
.**.*.***.***..***.***..*..**..*..*.**.*.****.*.**#*.*..*.**.********.****.*****.**.***.*.*****...**
***..*******.****.*..****.....*...**.******...****#..**..*.***...*.******..*.***..*.****..*****....*
***.**.*****.*****.*********.***.**...**.*..*****.#****.*.*.*.**..*....*****..******.**.***.***..**.
.**.*******.*****.****.**********...**.***..*****.#*..*.******.******..**..***.***.....***.****.****
*..*.*..***..*****.***.*.**.******.****..*.*******#******.***.*******...**.***......**.***.*****...*
**..*.*..****.*..****.*.*.*...*****..*.**********.#*****.**...*..**..****.*****.*.****..*....*.*.***
*.**.***.***********..****.****.******.*...***.*.*#*****..*.*****.**.**.**...*.***...**.*.*.**.***.*
.*..***.**.*.*****.*.**.**..*.*******..*******.**.#*.*.*.*.*******..*****..*.*.*****.*..**.*.**.*.**
**.*..****.**.**.****.**.**.****..*******.*.****.*#**...******.****.*****.**.*.***..*******..***.***
*..*.*********.****.***.**.*..***.***********..**.#***.***********...**.****.*.****.*.**...*********
***.**.********..*..*.****..******..**..*.****.***#*...******.***...**..**.***.***..*.*...*****.**.*
*.*.*****.*.***.*.*...**.**.*****..*.*..****..****#*.***.*****..*..***..*******.****.****.******.***
.*.***********.*.**.****.**.***.**.*.*.***.**.**.*#..**.***.****.****.******.**.*********.*..*..****
.**.*.*.*.*************.**********...*.*..********#*****.****.**.********.**..*.*********.**.**..*.*
********.*.*..*****.*...***.*.**...***..*****..*..#*****.*.***..*.********.*.******.*.*****.**..***.
..*.**.*.*.**.**.***.*.*****.***.*.***.*****.*.***#..**.**.*.****..**.***....*.***.*..***.*******.**
**..****.*.*..**.******.*.***...**..***.*.*****..*#..*.*.*.**....******..*.***.*.****.*..*.*..**.*..
*.*..*****.****....**.*.*...*.***..*.****..*.*.*..#..*.**.****.***..*.*.****.******.***..***.****...
*******.***.***.....***..*.*.**.*.**.**..*******..#*.**********.*****..**.**.*..**...****..*****.**.
*.**..*..***...****.**.**.*.*..***..**.**...***.**#..**.***...***.*.**....**..**.***..***...*.*.****
..*.*.****..**..*...************.****.***.*....***#*****.*****..**.**.***..**..*****..*.**.**.*.**.*
*****.**.**.*.*****.***....****...*..****.*...***.#****.**.***.**..*.*********.****.****.***..*****.
.***.****.****.*******..**..*****.**...******..*.*#......****.**.***********.***.*.**..*****.*.*.**.
*..**..*********..****..*..**.*******.******.**.**#*.**.**.*.****.*...*..*.**.*.**..**...*..**.***.*
****..**.*.***...*.*****.**..*****..****..***.*...#*..***.****.**.****.**..*.*.***.*..***.***...**.*
***...******.*******.****.**.**.*.**.*.*.**.******#..****.**.*.***.*.*.***..***...******.*.***...***
***.******..**.*****.**.*.**.**...*.***.*.********#*****.*****.*****.******.*****..**.**.******.**..
*.***.*.***.*.*******.*..***************.*********#.*.***.**.*...****.****.**.****.*.**...*..*.*.***
.****..**..**.******.*.****.....********.**.***.*.#*.*.***...****.******.*.****.*.*.*..*.**********.
****.**.*******.....*.**.*******......***.****...*#.***..****..****.*.*.**.*..**.**...*****..*..***.
*.**.....*********...*.**.***.*****..*.******.**..#..**.********.***********.******..**********..*..
*.***.*****.**.**********.*****.*...**.***.*.*****#**...**.****.*.*.*****.*..****.*.*..*.****..*.**.
***.*.***********.**.***.**.*.**..*.******.*.**.**#.**..****..*.*****.*..**.***.**..****.*.****.**.*
.*****.*.***.**.**..*****.*.*.*.**..********.****.#*.**.*.****.**..***..**...************..*.****...
.*...**.***..**.****...*****.*..***.****.***.*****#**.**.******..*....**.**..*.*.*.***.****..*....*.
.**.****.***..***.**.**.******..*******.**.*.***..#*.***.**.**.***..**.******..**.....**.***.*****.*
