******.**#********.*.
**.******#***.*******
****.**.*#***....****
#####################
**..*****#*******.**.
*****.***#**..*******
